stv: fjt tjt xdx
dgq: vmd nbk vgc jxk
jzd: gmt vjn cdz mkf
jbv: qrq
lts: bpd mlk tvq
gzz: pxt cpm ffm
qjt: dnr vnl fgg
ddh: kfq mjp
lkl: gnl
cdh: cqt
zmx: chh sjx tzq
gql: prh qmc
mjp: szv
vzr: qch tql
krp: vbt
mtx: zmr hpk qxf
cpj: dzs trm sgj
vth: lsm qhk qpq
cjz: hrl gjh fqh gtg
vqf: ttl jvt
gsx: hrv hdd pjf
mql: cxk
glk: mnt lxd xpl
cbb: mlk vds lgj jbj
jsd: jbk jbt jrs
hhv: ttg tkg mlk
bcz: gkc scj xhl
gmt: xrx
cpm: pdp
lvn: nns zhm kkq hpf
bnv: mnt jvz
tmk: zrk zch tzj tbj
crx: tdl hxx mst sqj
rkz: pth ptn fbd krp
hhd: npg mdc
zdc: frb lbd cnk xkj cmq
tqh: hjg
gvs: chf gxg
hcq: jvz vmr gkc
mlm: ckd
bkg: stk cqt ckd jhq dft
lpg: gts mqq jzv
hzh: jdp dpq xxv vzs
rbd: kbb pdv ldn tlv
zct: tjq qtx fgx
cjm: lkr
rhq: pbj
jdq: dts dkn jnm khc
qcl: hmp
fgc: jps nnh mpg hjg
lhv: kbd rhg rcm vdv
czd: sgz vlm nfq npq
zqz: sjz dhz tpd nxk
knk: nqf njq xtg
gmb: nzb rqb vnl mgs
vls: mgs ldq
ngh: dlb
nvr: zzt qfq gvs frh
fcz: zqg vdn ffh
znp: czr vnc
zzd: jjr zqf spn cbc cjl
sfm: xxk pjf jzc lrz
qkk: mlm dmf
czt: tkg pgm
zps: ndv fqs
vfg: clp mcc
nxg: qdp fqs
xls: qcl bpp
zqf: cdh hng
fzx: qfq
qmg: rmx
glp: bzr lrh rgk
thc: czf nqq jhl
jtt: gtj jlf jfc
gvb: jvt gvn tbd
zxq: vmb tgp hpk jvp llv
clv: cpj njx qjt bfh
xdm: prh cbt ttj
ftv: srs tvh jfc gds
cbl: zxv hxr
zcq: lcv
ztk: dlc tcz tdb fhk
bvt: gbj tdf cdc gbt
xfz: lzn ddd rkm fbx
ffs: ghj xcc mhr lpb
pkn: pjf
nls: lql
xgv: pkt ckx
css: nnp
gcf: vhn ksf nbv
jxm: jhl gcj
rjn: vtk fhn cmp
ttg: dbc mjp
gmh: gpj pkz sfj drj srl
dlm: fqs rmc dhz gqp
stm: cbz ggn xgv zbv
tmb: nmn vvc gpj gvj
fgv: qkh lfl cvd qvm
rkr: pbl ctm tcv ttv
kkl: tfp
fnd: lvb ttl pjh djn qxf kpl
bqr: fvg ggk vfc lbd mmk gkr
fsl: kps
zgl: msb
xcl: btf
rtc: btp lgs
tdb: fnf
lxx: nsp clm
gkz: trn
nns: qxm
vht: kcz hqq zfk cds
bxf: qgz kvt rvm rvk
hpq: cbp jzc
gtm: szr xdx gtg
jlm: mqq rff trt pjn
vhk: zkh
vvc: nmv jgn
jvh: jvv ckx
spn: cjl
jlg: mpm xpn phq nbj
ncl: ckx
fql: xdf cjn jns qgz cbp
kgf: nqr
zbf: xnx hkd xxk sht
nlx: mjz
bqh: skk jtt vvl nqq
vmx: mng fxs mts fnk
hgg: bpb jhd mcc hrv
cbf: xvh jvr
ngk: mzf vmd dqm
zjm: qrg slk bzt rvv
cxn: gdr
ckp: csd vds bfx
xpq: zch zhg rqm bpz
fsn: css mpr
nll: mjg qfj fxx kfq tlg
vjp: cnd
hzz: xnb bvz
slk: hsm gxg
zjj: hnf
vzs: txb
btz: mdc
mpm: nqf dhv mvh
jcm: smc hsm thc
smj: hlc
fth: vjp bhv
srh: dvt
lcj: gct kcb jzc dbg nbd
hxx: jgs
hqk: glj kbz tcr qrc vqh
xcc: vdv rpb
sll: xzf dtb
xvh: qhm csd
ftl: llv ldp qsx
vzh: pxt lrx lbn txz dvk
kvr: nxg zhb tvs
lsd: xxl zss rxr mql
fqm: cxb nmv dgn zmr hsh
fmm: szr rkm frb
dlr: srt gsr ghq zbc
qzr: gfg qtx jnm pxm tqv rxg
xnr: xzx mtc cqt
pmf: gts cps kkl fjf
rvm: qgr dhf
cvt: dpq trt sdl xgv
dln: ptn gnb jps
mpr: lsm pzl
ltp: qjt bpd cgl pgm
kml: gtc gzq hhl jhd
plx: gkn bgx zrj crm xpx
tcz: lxc
hnf: znj
kkq: qfj bsj
pbz: crm
zmj: btz zlj ctm hhp
dsx: tlj
shq: fvt dvt
fxk: zcd gzn prk mvf
kcx: zds ght qqx tnp
tpn: nkb vzr
zkd: qnp cdh jns
dpg: gln kbz zrj
vkr: tlm xkt zjm hrm
gvj: lmz
qnp: pbk
njt: ddh fdx hzh bfv
csg: gcm vth
hdp: smg szq xdm bzr
gxt: tlj hgs
qvp: rpd xkt
czv: njq
mkb: zrh zpl rmx vhl rmk
xjh: lbd zps ldm vjp
bmp: pnb hmp
xmz: hbl tmx ncb jgd
njc: xsg dzl zdb
xfh: xhp cmq jrs fgx
tvq: qmg mlk pll
rgk: smj
vnm: cpm znj ccj nqr
lvb: rtx
ftj: thk gqr npg zst
ppd: jqx rzt bmz
rzt: bmd xkz
rhh: frc ddg mtc jbv
hmr: cmq rjs kkq
kbf: lpg dvt ffm gns
xhq: gkz tcr thg
sqv: rrs nns tln
ggk: hnz pgm
zvg: bfh ncl cvk
mjg: qbm ttq nsp lgz
sxc: tvh vvs
zst: vhr shc snf
lxc: jns
mkm: vqh znp zss vmb rhq
fhx: png lbg
vkn: pqj hsh gzq
jgs: mvk
cdc: ptm qzd
lst: gjn nlh
tcs: crb crz
bgf: hrv
xvb: xrd btp tln
vxc: zzt htf
xxl: pgn fhs ksn
cvk: mxj kvj nlx
stb: zdq
hfs: vvx jbl rff
rmx: crq
mrz: bph
dgz: nqr djc mnd knk
pbl: sbm
jkn: dpg tbg hrm
mgs: vll
nbh: tlq mbq sld qbm
msb: klc
fjh: zvv
jcz: kqd tdl
tvx: ttl sfc
mnt: bbc kvj bph
bht: cqg qkk ldp ltb
vvs: dnt vfx
kdr: lgn qsd jlt
rct: pvm flg lrq bsj dhv
vdx: grl pps mts grs
lzm: fck mxj cpm dlq nls
tbh: xrx
gzn: mhk lbx
jvk: bfv jrd kps fsm lnm hrk
pth: pzl ldp gvx
ngj: fnl zfk qzr tgd
vdn: rgt czr pjj
zvz: tlj nbv
xfg: xkn cxb
hnp: vdv cjn zzv
mgr: zfd qkk tmj
jrh: dzs
czf: vfx
pvn: ldm dzl
lbh: qpg zlc
nbj: kcz cps
gpm: bkv fmm lzp cdc fxv
zcf: xfb xdb mnd czt vmq
rtb: vhl ldn nxk gtm
ccl: znf mbp vjd
sld: rdz gst
dbn: tbz gvx vrd pkn
zvc: nsc mcq
jhj: jlf sqd lkl jcm vvl
vhf: pnb
ptm: tfp tlq
srl: vtk hdx zct
frj: jjr qrg
zfk: rrj rqb
fnf: rzx jns tqp
xjs: hcx shq txb gmb gch
tdq: mhk xfg smc
gmj: dck cks gzz pjn
khc: qmg nlg zsd
zrh: gbn
qtx: kfq
rxj: tbg ftv dhf bkh
ldr: nsc rvs srt
cxp: zdb
bqn: xmt zgl bsm blp
flg: gst
vmq: lll
bjb: gcj mcc lvb
nqc: vxq tjg xhp sld
bfh: cxn
qrl: mdr pbz vvl
vxq: dnl lgs gnk rtp
jbh: rvp
jfc: ddk mtc
rvd: jlc ndv
ncb: srd gkn
bjx: bsm ltb
tpx: czv szr tfp
vhr: mvk
qdp: kps zsd
djc: vdh
sjz: kbj tlg
qrc: hxx
tpt: gnj
cbc: cqt
cpq: mvb jxn
njb: dbb hrx pxm
xmm: bmg zpz kkq qfk lgs
tbj: dlk fpf
jbj: csd lgj
vfc: mng qvj
cnx: pdv
cnk: shq jhg
fhs: jxn
fxx: fhf vnl ncf bvp bpd jhg
hth: mqq cks gjh pvm
rmc: skz dcd xdx
qks: bhv
zhx: zmr jtx qxd
mbq: vdb hpg
psk: bkc zzx
mlj: txn fcr rvv
dhf: xqn
nbf: zbl hsb
gnj: zhm
hrb: rrj tkg rff
gfr: pll
rvp: lks
tmx: frj zbt dlb lbx
lhl: kqd csg rxx
mxz: pkn nnh
jjr: tlm rvp
bkk: zhk bvx qqx tkm psp
hbl: mdc kvt jvp rkd rvm
gnm: pbl bmz
xgh: bsj gcr hrb
rmv: rhq
smg: btf sqz jhl
hcn: bbc fjt fqq
prk: bgf pkk
zjf: hzq
ffk: dvk rxm vvx kdr
dbz: vhk hqv djn ndx gpl vqf pnx
pdp: vkl nqf
gfg: nls mrz
rkc: srh
gxz: dpq fhf rng
ssn: rnx mmk qtx ljz bkc
dgc: dbg rcd
gqr: gmt pft gcm
ksf: pdp fsb lxx
rcx: cqt
qqr: qsx jbh gcm sqj
gxl: dfk sdc vmq
hkl: dts
lqq: cnx kkl sxr
rlt: czf ptn zzb xbf
djj: jxt shc pgj
kcc: gkn
jkv: srh
nvk: dtb hsh sgg qgr dpd
kxz: gbn tlq rjs tql
bfp: fsb bdt vdb fsm kgl
cbz: xpl pdp qch
pqv: txn crx mql bzz
vrb: rfc fcr rqm zrj
gkr: tpd rmk mdm
clm: kqk
gpl: lqc frh
kbb: tlj kbk tzc xvb
vkt: vzs gpr hxl
nfj: smj qvd
tcm: xhl
smk: fpf ncb szq gdv dmf
jlf: kcc
txx: lcv rpj lfj fzq
mxk: glp lxv zmx frm
sjp: ggt mvf zbc pjf
scj: gpf njq
sms: nqq
tmh: ctf zxq vvl dcx
rgx: vqc vkl hbz rlc vvr
hng: nvd
bkh: vnv zxv pft nsc
mrb: gtx sms mtc gnb
vgq: vhf xzx fzg
thz: fhn jkv
lsb: jbl
clx: vtb zhg ghq znf
lsz: dzl lrk llj dts
dbl: btp dck tfp
jgq: fgg qrq ttq
lcb: tsb tpm mlj
thk: qkh vsl kcb
csz: rvv bmp dnt
ftt: hhl rmv bpp qdm
xzx: hxx
vmz: vtb jxm crz bnq
cgl: crq
vxh: xvh rkc lxd vkt
ggt: xcl
nmv: bjx htf
fbd: rcx
sjl: fxs
hhz: lxn rfb qbs gzz
fzq: qlh xms lzp
qsb: rhg vmh ndx nfj vvs
xrd: cbz pvn
zhg: xrx bmd
dnl: pjx jzv
smt: jbk cds
hlv: gxz qjt njx qgp
rbk: hlc rtx fzx fjl
qgz: bnd dhf
tcv: mzf ngh sms
vmr: lfr ggr
nsp: bhv
jht: zfs bck tvp vkc
pmn: jps bql cbl
zpd: lgn mjp dst
drn: lst lkr ssb
mjs: sbb jvr xfz bbz
grs: ggr prp cvs srn fbx
zvv: bgm
tpd: dvt grl
thg: hpk gxg vbt hng rbn znf zkd
llm: sll ttj lqc
bvx: txz vdk ddh hbz
gqg: dsp szr dzs
zqg: tcj lvb tgp
vmd: zlj ntk
cbp: qfq
ldq: cfx ttg zdb
xhp: cjm lql bvz
vdc: xnb vvr gkc llg
xtg: nbj ndv
nhc: lkc rbt
llv: cbg
kpc: mlm fpf
vjh: zds zcj hjz hzz
rsc: ddg vcl
qxt: tlj
lzp: rsc
fdx: lnm
tgd: jlc jvv
mkc: sbg bsk ttl qjk
kdb: sfg cbl ttj cms
kbj: gbn
ffh: zrk klc pkn
ktm: jcz jgn pgn pnd fcr
lzd: crm glp phk rpd
dlq: fxs sjl jvb qbs dhz
zrk: lvx zbc
krr: rtr sjc gkz
bkv: xtg dmg bnv cks
nbr: thj tlv fhx lll
lvt: mnd fqc tvt tlg
vnc: cnb rvk
smx: vdx prp jvb hkl
dmf: vbt bnq
ldh: mtc hhl
qsf: tgd thz lpg
mxh: qsf vqc jbk pkt
cqg: qvm
dlc: cvd glm tcr scq
vbn: lhl nnh xdf cqt dqm
rxr: zsm glf
blp: dqm mkf
mcm: vdc lts vcl
njx: fqq bdb rmk
rnr: tvh vbc
rkm: jnv zrh gfr
jth: bqz fcr krp qdm
rng: lcv rfb gpj
sxt: lxx drj dbl shq
gpj: vll cvs
hpf: vll lkc
psm: glp qvp nbd qpq
tjq: sgz tlj dhz
xkx: pnb rnr lqn rhq ztj
tgp: phk bsm rhg
vhn: fvd vdh
qxm: srn rqb
kcr: hrv lcb ksc lfl
fxv: kpv vls kmp
vlm: szv mxj
gtg: kkl
hbz: lgz tpn
cps: hqq
rdz: hdx tql
pln: bhv vzs vkl
hrm: ldp bzr
bjv: pbp bzr crx hvp
sqg: plz fml rxg rsc lqq
mmk: dsx tfp
pkz: mdb hvs
rlc: tpt zjj hdx
kfm: fgx ddg zdb cxp
dpn: vkn zjf scq rzc
lxd: tlv
rcg: xxl hbl sgg rvk
kgr: ztb fgg dnr lst
xfb: vdb mdm jlc nlh
kzc: gxg dbz fgr vhc
fml: gbn vlm hmz nlg
mqq: hpf
mfp: prk ztj hlc zzt
tpm: ckd bmd sms
dcx: crb fhs vhf
ttc: fgl
kzr: qzd ndq zcx fqc
bmh: xzh
nmn: jqx qvd
fhn: hrk
lrz: tmz hxr mcq rkd bzt
fjl: ngh
cds: ttq srh
mjz: jhb
ttv: fhs smz fgr
tzj: jmq jbh
vsq: cxp qxc frb
hsr: zsb cms jkn ttc
brf: ljz dkn jhb cnd grl sdc
jzm: qkq lgs pkt
tch: mdr znb sbm chf
jlt: vmq
rxm: ndv
xtx: mlj vjq nmf tsb
kts: vds zpz zbl zpd nxg
lbn: pps hgs
zch: kql dtm cxk gds
qqv: grg qvd cdn qpj
szs: qgz rmp zmr pkk tcj qpj dxn
crz: mbp
xmr: tbh xkz sfg
jhc: pbz xbf gln
tzc: qhm
rrn: kfq kgf bkc jbk
drj: zkj vnl
pbv: czv mcl vzs
mtq: qhm qsd njq
tzq: msb fjl
ctf: hhd vhr gkg npg fcz
hkp: jsd vcl mjz kgf tvt
sdl: zvz qch
phq: gpf fsl
ztj: zxv
gbh: txb dbc
tcr: nfp
zhk: hnz
dfh: dzd zmj tbj jjb
lbd: ncf jlc
qdm: ntk klp
frm: pbj rzx mtc snx
tvp: znb jhd
ndx: bpp
gqp: gdr hqq szv
tdg: cmf tlm gtx
msr: dft cdz fzg hsm bxj
nml: jtq bjx gct
ctm: cqg gnp jxm
qds: ldm
lgz: kqk
nbx: zvj jck jvh
xph: pbl chh tmt zsx
gzc: ktm hxr gtj
vxk: lcv hrk vqc hqq
qbs: ncl qxm
lpb: bjb dnt
vxl: gnj
dxg: fjf cgl nbx crq
zkj: fnk rrs gbh
kdt: jjb smz tvh xcc
qhk: xbf xxk
lrx: sgz
ght: kbj bvz
tnp: lvn vlm njc
rvs: spn dzv cbp vhk
bkn: ckx fqq jkv dmg
bzs: qgr tbh sbm pbk
btp: lck
hxl: nqf lfr fhq mvh
xnb: djq fdx
xrr: vcl zrh mcl bbz
nzp: zfd frm ttj
cng: kpc jgs qhk qfq
sbm: gnl
gcr: ssb qnf cmk
mdm: rbt zvv zds
pnz: vvc zzv jhq gnm
rmp: htf
gds: rbn
pmr: gzq btr rpb
pkk: lxl qkh mtx
vdk: rkc
pbp: rkd nxs
xxh: blp qkh kvt szb llv dbg
nzc: brn mfb zkh zjf xzx
nsq: zpz xms glk jvz htj
tsb: lmz qcl
qpg: jjb jqx rtx
cbn: ncl fhq xhk pkz ldb
bvg: rfc ksn fsv rhg
skb: llg nlh xhl
sdc: dts dzs
gvt: vmh qrl bvl tbd
dxj: jnv nhm dck
ppc: ldb tpn bdb ncl
jvb: tcm
sqz: lqn
dst: qks
skz: bbc tzc
vtf: zpp glf
dvc: qch kjd zzx szv
vtq: ghl sqz fhl qcl mcq
rfc: glm stb gsx
rtp: fqq
srd: jns
kgl: pll qxc
kbk: zqq qmg ghh
tdl: lqn
srn: gdr jnm rnx
vpd: btr jxt
lbx: kpl nnp dzd
pnd: hqv pbj
smz: snx
xhf: hnf rdz gxt
qlh: ddg lll
rgt: pnx
fht: xfg lsm hrv sjc fgv
bfx: bgm lfr
qxc: dts hnz gqg
nmf: zkh fzg
xxv: dnl rdm dvk
pxz: ltp vmj gdr lxn
tvt: zcq
ltn: zzb gtj trn
mkz: rrj rdm frb llg
cms: gcj kpl
cpv: nhc kcm jrh dhv
gjh: bfx tlj
btn: cpm
bvl: hdd jps pbl rzx
dzq: pxk qcf cxn vhl lcv rtz qrq
vqd: jvt tqp
pft: dbg
xgk: dlb krc bql
qzd: mxj
ddf: rtc rtp sjl kqk
bst: lqq crg ggn czv vdk
qpq: fgl lks gsr
fvj: pxk hrl crg
vdg: jck
nsb: ddd zhm qxt scj
fqh: ght tlg hhq
xdf: jtq
nxj: bjg bql nss sxc
crt: zqq gxt fsh vds
bsk: vmb tmt
kvt: ttc
jrc: txn rvp cdn smj
tkm: pbv tjt vdg
lrq: njq dcd stv
msd: bfh nls kqk
gvn: bgx rvk rgt
czr: vmh qrc
lqc: lrh
nnv: zhk gnk bmr vvr fjs gnj
pfp: rzt gnp hhp
pkt: jlc
cmp: hrk ddg jgq tdf
dkn: bmg lzn
pmm: cvd zgl lbh mst bgx
qkr: sht tzj cbt ccl
mss: rmv tdl vhc gnp
kpv: fds qqx fnr
hxz: jhb dvt
dcd: zpl qxc
lvl: zkh lks frj qvp
jjb: jxt
tmz: hzj zpf
hsb: vdg rfb jhb
nmx: msj ssb kpv
bpb: sms
zdz: gpf mrz pps
hxf: zbl
phm: cjm dsx fjt nfq hhf
pvm: fhr sgj
sqs: ggt pfb
rbv: lck qxt zrh flg
xbf: rzx
qvj: jbk gst
kks: jgd zpp zlc zpf
kxd: rjs fjh fxs bcp
pqx: bzf sfb sqj xkx
rcm: gpl xzf bgf qvd
ghh: ccj vmq nkb
ggr: zhm
zlj: chh gct
lfn: bdf qcl pgj clp
nlg: tzc fxs
krf: jgq hxf jrh vmg
vjq: ptn
jhq: zxp mst jzq
xdh: qpb ttx fhq svg
mpg: zss cdh
tnq: gch
gtc: qrs tcs lpf mvb
gzd: gjh cgl rvd
tpk: vkt smx tcm lcl
bnx: lxc frm sqt bbd
rvk: tcj
qnf: hhf hcq rtp kbs
pjh: kcc
qfn: bnq gkx smz nfp dxf zrk gnp
zmd: kpl hpk hzj sfc
cmk: dnr ckx tln frc jlt
znf: cbc
fhk: nxs dxn ztj
kbp: nbf ckp pxm bvp sxr
rzc: vnv rbn bzr
fgh: sgg btr
fsc: jbh hmp mzg czf
llx: jhg
bzz: tqp
vnv: nlm jgs tdg
kmp: fjf pgs btn
dnt: gtj
lfx: kkz
lsm: crb sfg
lfj: lzn qzd
fpl: tmj pbz zbc zxv
xhh: hqq tjq rvd hmr srn
hkf: fsb zsd pps fml
nzb: dts jkv
zpf: srd hxr
gdv: hhp qvm
rjz: vlb pkn lfl
xkj: nfq fjs lxd
jcj: fgr zgl bzz xls
jgd: lpf rvs mhr
fcr: nfp
lpf: xcl lvb
bgt: fsn hxx xgk clt
bdt: bfv gch cjm
skl: zvc vxc
zkf: vnv tdt qvd
ksn: tmz ldh
kbz: btf
rkd: vjd
ghl: gvt znp klp gvj
shc: nvd
bph: llg pll
tsp: kvr pvn sgz nkb tqv
xbt: ccj kcz
chn: kpx pfp lzd zdq
gsv: kpx lvx kvt ldh
bxj: jzc mkf
mhr: nvd
fqj: xkz lxl zrj
zbt: dlk vhr
fck: txq qfk zpl
ttd: zjf qsr pnb
kbd: gvs dpd dqm dln
rch: pbp pqj nzp gsf
jjp: hfs pjn jrd bgm
cxv: rrn psk sfj lkc
ggn: nzr jvv
xkn: cqt cdh
bjf: jlf zbt fpf njg
vrr: pzd qmc hzj fsv dlb
qqx: lrk
tvc: cpq pjh dzg dxn krr smg
kcm: jvh qrq bfl mcf
dfk: lgz cbz nbv
brn: xxk tbg kkz
sqq: mtx hqv pnx pbk lpb
pzd: vmh vdv
lpj: bmg lck ptm fvj
cxk: cxb zhg
nnp: tcr
thx: zpl
ldn: fqs hrx
ffm: vdl tzc mvh
fnl: vhn
nhm: rff
txn: gcj
fgs: skk css fdz
djq: qfj clm
xnx: chf rgk qkk mvb bgx
kbx: cnb vbc lxl cbl
kln: frh nbg stb vpd nml
krg: dbb vxl cnd mts
fhl: fbd jvp nbg
jhg: tpd
zbv: btn jrd tvs
ncf: xsg dsp
mbp: mhr
tmm: dbc nhc rgz fhn
lzl: flg smx sfd fqq zdz
bdf: nlm css cmf rmp nzh
nnx: vmt mlj dft mqd mlf
nxk: jvh pjn gfr
lvx: cjn
lxn: jbl btn vhx
sfb: gnm ttl
dhc: vnt dlv vvc gcj
gbj: djc ggr
nnh: zss gzq vjn
rjl: ndv jmp nrz rjn bmr
zvn: hpq gql lrh vgq
kpx: qmv qnp hvp
lcl: bdb pxt
mlf: klc stk zsb
bch: bkc rxg
jgn: msb
vkc: msb ffh gft
fds: bkc rdm qks
hqv: qpj rpb
zfs: xqn hpq dtm
gpr: zps fhf gch
ssb: lck dxj
jxk: zzb qvm qrs vtf
cmf: gkg vjn
cbg: tqh
cpk: smt ksf jbl qvj gfr prs
frh: gtx
jck: vmg
thm: fhx fsh qgp
bpz: ppd xbf ttc zmr
lrk: ttq pln
klp: xzf gnb
kqd: lqc
gjn: mcf gnk
qmv: bnd tvx
qcf: mcm xbt vxl
bjg: qmc qpj ltb
svg: tjt dzl
ntv: pxk qxt mgs zpz
mst: kcb
qrg: cvd dlk
vlb: xzh ltn
krx: xpl drn qds xtg
phk: sfc
fvl: rtc bbz ccj sfd
gkh: bfv jnv thm qpb jjp
mzn: rxr mgr lkl zdq
dgx: lsm sfc bks vfg
nzx: crt ggg msd mcf lql jzv
bbd: gcm xzf
qss: bql jhl hjg
njq: fgg rxm
fjf: pgs vdh
tbf: tdf jvz gfg
sjx: xrx
zsx: tqp sqd dnt
shk: nmn tdb vjd
kql: jns
stc: bpb pth dgc zsb
nbd: mvk
rcd: qpg dxn
sdf: trm jbj sqv psk
sql: nsp sqv dhz cvs
znj: fsl
zcd: zlc xkz pjf
lbq: cbl xnr zkh mgr mbp sqs tdt zmx ngk
dqm: qgr cpq
txz: tnq nhm
ntt: rgk qnp
qgb: jnv sql rdm gts
zcj: nxn bnv
hsn: czr szq fgh mdr
dlv: mcq
gjq: fzx sqs bkh fhk
njn: qfk svg kps jbv xtx jvb
hmz: dvk nrz
pkd: jzt mnt gst lkr
lmz: jqx
pfc: xpx gvj rcx lvb
zdn: vqh dbp zqf fgh
cpd: sqd stk cnb
prs: tlq jgh cks
mmm: qfq sqj rqm tlm
bqz: vxc gkz cbp
xbb: rpj mpm tvq
xpn: fxs
gdq: hcx qdp gns
bjd: qmc mpg lrh
jmq: pbk
jdp: fnl mqq xpn fbx
xqn: pjj zdq
gjl: zpp pzd
dcp: pgm fth rrj tlv zhb
jcl: pnd mlm ggt
ppg: nbm srt ttj lrz
xgx: fpl vpd xcl fsn
bbz: skb prp ggk
snf: nmn chf
ksc: nfj gtx rjf
vqh: dtm
bfl: rrn sfj
nss: xkn snx lvx jtx
dzd: jmq gvj
mdc: gkx
rbt: rqb htj
rpj: gns fsl
crg: hpf pjx
vnt: xcc mpr pfb xpx
sht: jvt
vdh: cxp
dpj: gdv vlb djn jcz qrs
tht: tlj rxm thx gzd
gft: xdf fzx srd
jzq: lfl fsv
pgk: tnq rdm sjz dbc
mvf: gsr
hvs: tkg zvz gkc
rzb: gtg prp dst
tsx: vhc ntk xbr
qfk: bgm
cln: npg nvd vhf dtb
gts: rfb
lqg: jrh dst fhr sbb
cgr: ghq tcs dlv bmx hlc
gst: jhg vkl
dft: mzf
mxp: bqn djj mvf mpg
sxp: ckd gct nbg jvp
rgz: lsb zkj trg vfc jzm
mjj: rcd gkn qss
txp: dpq xnb jzv kgf qlh zps
qsr: qsx ccl gct
zpk: lsd xmr btz llm ldr vfx
vtb: mdr pgn rvp
hhl: vqf
hsm: fbd gln
tbz: gzc zsm gsr
dfb: dpg ntd kbx gsf czr
jtx: krp hrv
ddk: nfp htf kkz rcx
rqm: jcm nnh
flk: hzq vsl tdq zbt
lkr: kbs vhx
mnd: sjl lsb
cvs: rrs
ttx: jck xfs tdf
cdz: sqd glf
tsk: phq rdz gcf vmx
gxf: hnf zcq pgs vmg czv
xgp: vsq mrz lql tvs sfd
zbc: nqq
mkh: xpx tbj stb
rtr: bbd lpf xkt
mqd: zjm gkn gsr
xbr: qmc hng nlm zsx
fsm: cxn
hzq: krp qss jxm
trg: lfj vdg cbf
lhh: grl jmp tbf dnl
bmz: rcd gds pgn
dhv: tpt
tdt: mkf nbd
fgx: rkc
mng: zvv hhq rmx
hrx: zsd hzz hxz
tmt: kbz sht jgn glf
qpb: llx tql
vgc: dpd shc bnq
vvl: nsc
fqc: vzr gtm tlq
scq: gkg sqt
thn: hjg ttd tcz tvp
vqc: lnm
nqh: pjj pbj xzx
dzv: fhl
szq: ztj hpq
rtz: mts rzb skz
jgh: tpt llx
fnk: gdr pdp
pxk: cps zqq xfs jbv
fvt: kcz xfs nlx
mhh: snf rpb bmh cjn njg
fdp: fgl jgs zlc btr
mhk: jtq
cbt: kpl vmb lxc zzv
vnx: shk fgl qkk xnx zmj
ghq: crm nxs klc
qjk: mjj zlc
tbd: kql sqq
dss: jtq kpl rmv nvk
ljz: fxs hxf
mfb: jps sjx
pbg: lfr clm pdv zjj jlt
dzg: jmq glf qvd
sqt: mvb
vcj: fsb gbn cbf qfj
hlb: gjl ccl gcc sfb rjz
mzf: vjq
rzl: vqd cbg css tjc jhc dtm
rrs: hnz
hhp: qnp
sjc: ckd zmr
lcp: rmc nsq vmq
lqb: tcz gvn xzh gtj zxp
zfd: rpd
dpd: vxc
qmt: hdx jvv lcl hxz dgz xfh lzp
gcc: lkl hdd sgg ggt
cmq: fbx
glh: hhv vdg zvg cnx
rjs: fsh
trp: jns cpd csz zxs
clt: gkg crz bmh
nvn: fsb jnv tpx tcm
qxf: mcc
dxf: bjg nbg kql
jhf: jxt lxc csg pjh
rkf: tvt nrz vhl hgs nmb
fkf: dlb skl jhl crx
nzr: vcl nkb
zhb: xpn jzt
trm: bnv fth
pzl: jxn smc
zmn: zqq ljz xbt
ggg: zjj cbz
trt: gjn pkt thx
psh: lqn pjf mxz kkz
grg: nqq zpf nfp
srs: prh vdv qsx nzp
prh: smc ltn
jrs: mcl tgd cnx
tcj: rbn
mzg: dmf kkz
pjn: gnj fvd
xhk: cnk xgh nnv pxm
rrz: hnp fqj qkh lmz bjx
vtk: csd
zjp: gxl dck nmx jnv
skk: ncb
rff: vll
dbb: tkg llg
jbt: gqg
cfx: tgd ggg
sgj: kbs gnj
ldb: clv smt
zds: ldm
mdb: zvj dvt zct
vjn: zzv
zvj: vvx vqc
nsv: mtq tqv lsb vqc
pfb: bmh krc
gxd: dbz fzx jzq qrc
fgr: tqh ndx sfg
plz: hmz mts ddd
zcx: bpd vls vvr bfl zcj
fnr: dsp lqq
dsp: xfs
bzt: hsh kcc
gvx: snx dlv
zzb: zmr
qkq: lgj vtk nrz
srt: lfx
njg: sqz vtf nmf
tln: tnq
rfr: jgh mjz pjx sfd
jfs: fsv tsx mfb
glj: pgj jxn vhc
sbg: qrs tsb
glm: pjj bnd
hkd: sqt kvt
dbp: kqd rfc bpp gjl
jsh: vbt xls vqd xkn
lrh: sms
rhl: nmx lbn zqz hrl
npq: htj xsg bfx
dpm: gzn sxc rkt qjk
hpg: nlx djc hcn hrl
ndq: hkl ddh dsx sxr
dmg: nbf bgm
fqs: vvx
ntk: pfb
bsm: tvh
hzj: crb
hjz: bcz ptm vmg
vjd: gnl
pjf: rtx
txq: jbt bbc fvd njb
fdz: tcz bsk bzt
dzs: htj jmp
gsf: pgj css
nzh: vtb skk xpx
vbc: sll krc
qtv: thx jmp rff
tmj: lvb nxs
rll: crq jbt zmn pxt
cqk: tzq bgf gzc zvc mvk
lgn: llx txb
hdd: zzt fzg
bck: djj jhq tzj
kjd: nqr nzr lrx kvj
pqj: nbg tcj gkx
lnm: bvp bsj
hcx: zbl hgs
fjs: rxg bgm djq fjh
vsl: phk xkt
stk: jqx
sfd: sdl
nxn: phq mjz nzb
vmj: jnm kgl qvj
hvp: kcb xrx
grt: jvr jzt pvn vjp
vdl: hrx lrx tcm
lpt: kml dtb zhx dgc
fhq: rnx fsh
rmk: pgs
fhr: hxf pjx
cnb: bzz
dnr: zhk
llj: xsg sdc thz cds
png: qsd vkl fjh
frc: jrd rrs
lbg: lgj cfx zvz
lck: nlh
ccr: cjl btf rvk bjd
dzx: nzp pnx gnb chh
zlc: xrx
bcp: mts tqv xhf
fmd: bsj gfg kbj lvt
gbt: czv bvz zvv
thj: xbb xms zcq
knh: cgj zsb mzg ldp mql btz
vmt: ltb xhq dlk kkz xfg vnc ftl mkc
tbg: rgt
rxx: cjl lcj qmv
dfn: kvj rnx smt qsd
nbk: bmx kpc tcv
nrz: nfq jkv
nmb: gbh zdb pdv
ddd: tgd
cdn: gvx
xdb: fsm fvd zrh
rjf: gql sjx nqh
zzs: mgv cxn fnr qbm czt
qpk: dbg vqf tqh krc
ztb: znj frb qds
lxv: mxz hhd ntt
zsm: cxb tdq xkz
fsj: xmt lxl tvx jcl qsb
psp: xms jbj fjt
tjc: cbc btf rnr ngh
qsx: mhk mkh
msj: qch gbj pll
bmx: vfg vhk qvm zkf tqh
ntd: dzv jhd bmp tdb
brp: qrg qxf cbg sbg
fvg: fhf tjq zqz
bmr: xnb vdb
rrt: lgn mvh gdr kbs
trn: gnl
szb: gsx gkx
clp: ltb gmt
nbm: cdn fgs lbh
jxh: qds lzn mcf xpl nhm
hhq: nls sfj jvr
qxd: dzv lfx skl hrv dtm
znb: vfx lks spn
vhx: gdr zrh
hhf: rxm vmr
jzt: bch
qgp: vmr qdp lbd
gzj: ntt smj jgs nnp
pmd: qhm mbq txp zpd
mgv: qbm mcl vdk fnl
ghj: nlm pft sqj
rvv: sjx
zzx: zjj qtv
cgj: srt pnb mlj
xmt: rkd bnd
gln: cqg xxk
vdv: jns
cnd: lkc
krc: xzh lfx
rkt: pmr lsd fdp
hgf: lxx hkl tjt bch qks bvp
sxr: bdb
bmd: hsh
gsm: bmg gpf hcq xbt
bks: hkd tbh rfc
xdx: lkc
dgn: ldh qrg jfs gvb
nbv: lll fdx
tjg: rjn vxl tpd
gnk: xhl
vdt: mkf szb fjl rpd
zxp: lbh vjq pmn
sbb: xrd nns
zxs: zfd zpp rmp
vrd: hmp bxj slk
dct: gns tvs lcp knk
tfx: bpb trn gql shc
bzf: djn znb cqg
qsd: gdq
